WWWWWWWWWWWWWWWWWWWW
W   W     W     W  W
W W W WWW W WWW W WW
W WGW   W W   W W  W
W WWWWW W WWWWW   WW
W       W       W  W
WWWWWWW W WWWWWWWW W
W             W    W
W             W    W
W WWWWWWWWWWW W W  W
W W             W  W
W W WWWWWWWWW W W  W
W W W       W W W  W
W W W WWWWW W W W  W
W W W     W W   W  W
W W WWWWW W WWWWW  W
W W       W        W
W WWWW  WWWWWWWWW  W
W                  W
WWWWWWWWWWWWWWWWWWWW
